***********
***X*******
***XXXXX***
***********
***********
***********